101 101 101 101 101 101 101 101 101 101 101 101 101 101 101 101 0 0 0 0 0 0 0  0 0 0  
0 1 2 3 4 5 6 7 8 9 10 101 101 101 101 101 0 0 0 0 0 0 0 0 0 0 0 0 0 0 0 0 
101 20 19 18 17 16 15 14 13 12 11 101 101 101 101 101 0 0 0 0 0 0 0 0 0 0 0 0 
101 21 22 23 24 25 26 27 28 29 30 101 101 101 101 101 0 0 0 0 0 0 0 0 0 0 0 0 0 
101 39 39 38 37 36 35 34 33 32 31 101 101 101 101 101 0 0 0 0 0 0 0 0 0 0 0 
101 41 42 43 44 45 46 46 48 49 50 101 101 101 101 101 0 0 0 0 0 0 0 0 0 0 0 0
101 60 59 58 57 56 55 54 53 52 51 101 101 101 101 101 0 0 0 0 0 0 0 0 0 0 0 0 0 0 0 0 0 0 0 0 0 0 0 0 0 0 0 0 0 0
101 61 62 63 64 65 66 67 68 69 70 101 101 101 101 101 0 0 0 0 0 0 0 0 0 0 0 
101 80 78 78 77 76 75 74 73 72 71 101 101 101 101 101 0 0 0 0 0 0 0 0 0 0 0  
101 81 82 83 84 85 86 87 88 89 90 101 101 101 101 101 0 0 0 0 0 0 0 0 0 0 0 0  
101 91 92 93 94 95 96 97 98 99 100 101 101 101 101 101 0 0 0 0 0 0 0 0 0 0 0 0 0
101 101 101 101 101 101 101 101 101 101 101 101 101 101 101 101 0 0 0 0 0 0 0 0 0 0
101 101 101 101 101 101 101 101 101 101 101 101 101 101 101 101 0 0 0 0 0 0 0 0 0   
101 101 101 101 101 101 101 101 101 101 101 101 101 101 101 101 0 0 0 0 0 0 0 0 0 
0 0 0 0 0 0 0 0 0 0 0 0 0 0 0 0 0 0 0 0 0 0 0 0 0 0 0 0 0 0 0 0 0 0 0 0 0 0 0 0 0 0 0 0 0 0 0 0 0 0 
0 0 0 0 0 0 0 0 0 0 0 0 0 0 0 0 0 0 0 0 0 0 0 0 0 0 0 0 0 0 0 0 0 0 0 0 0 0 0 0 0 0 0 0 0 0 0 0 0 0 
0 0 0 0 0 0 0 0 0 0 0 0 0 0 0 0 0 0 0 0 0 0 0 0 0 0 0 0 0 0 0 0 0 0 0 0 0 0 0 0 0 0 0 0 0 0 0 0 0 0 

