5 5 5 5 5 5 4 4 4 4 4 4 4 4 4 4 4 4 4 4 4 4 4 4 4 4 4 4 4 4 4 4 4 4 4 4 4 4 4 4 4 4 4 4 4 4 4 4 4 4 
5 5 5 5 5 5 2 2 2 2 2 2 2 2 4 4 4 3 3 3 3 3 3 3 3 3 3 3 3 3 3 4 4 4 11 11 11 11 11 11 11 11 11 10 10 11 11 11 11 4 
5 5 5 5 5 5 5 2 2 2 2 2 2 2 4 4 4 3 3 3 3 3 3 1 1 3 3 3 1 1 3 4 4 4 11 11 11 11 10 10 11 11 11 11 11 10 10 10 11 4 
5 5 5 5 5 5 5 2 2 2 2 2 2 2 4 4 4 3 3 3 3 1 1 0 0 0 1 1 1 1 3 4 4 4 11 11 11 11 12 12 12 12 12 12 12 12 10 11 11 4 
5 5 5 5 5 5 5 5 5 2 2 2 2 2 4 4 4 3 3 1 1 1 1 1 1 0 0 0 1 1 3 4 4 4 11 11 11 12 12 10 10 10 10 10 12 12 12 11 11 4 
5 5 5 5 5 5 5 5 5 2 2 2 2 2 4 4 4 3 3 1 1 1 1 1 1 1 1 0 1 3 3 4 4 4 11 11 12 12 10 10 10 10 10 10 10 12 12 10 10 4 
5 5 5 5 5 5 5 5 2 2 2 2 3 3 4 4 4 3 3 3 1 1 1 3 3 1 1 0 1 3 3 4 4 4 11 10 10 12 10 10 10 10 10 10 10 12 12 11 10 4 
5 5 5 5 5 2 2 2 2 2 2 3 3 3 4 4 4 3 3 3 1 1 1 3 3 1 0 0 1 3 3 4 4 4 10 10 10 12 10 10 10 10 10 10 12 12 12 10 10 4 
5 5 5 5 2 2 2 2 2 2 2 3 3 3 4 4 4 3 3 3 1 3 1 3 3 1 0 1 1 3 3 4 4 4 10 11 10 12 12 10 10 10 10 10 12 12 11 11 11 4 
5 5 5 5 2 2 2 2 2 2 3 3 3 3 4 4 4 3 3 3 3 3 3 3 1 0 0 3 3 3 3 4 4 4 10 11 11 11 12 12 10 10 10 11 11 12 12 11 11 4 
5 5 2 2 2 2 2 2 2 3 3 3 3 1 4 4 4 3 3 3 3 3 3 3 1 0 0 3 3 3 3 4 4 4 11 11 11 11 11 11 10 10 10 11 11 12 12 12 11 4 
5 5 2 2 2 2 2 2 3 3 3 3 3 3 4 4 4 3 3 3 3 3 3 1 1 0 0 3 3 3 3 4 4 4 11 10 11 10 11 11 11 10 10 10 11 11 12 12 12 4 
5 2 2 2 2 2 2 2 3 1 3 3 3 3 4 4 4 3 3 3 3 3 1 1 0 0 0 3 3 3 3 4 4 4 3 3 11 10 10 11 11 11 10 10 10 11 12 12 12 4 
5 2 2 2 2 2 2 2 3 3 3 3 3 1 4 4 4 3 3 3 3 3 1 1 0 0 3 3 3 3 3 4 4 4 3 3 10 11 11 10 11 11 11 11 10 10 11 12 12 4 
5 2 2 2 2 2 2 2 1 3 3 3 3 1 4 4 4 3 3 3 3 1 1 1 0 0 3 3 3 3 3 4 4 4 3 3 3 10 10 11 11 11 11 11 10 10 11 10 10 4 
4 2 2 3 1 0 2 0 1 1 3 3 3 3 4 4 4 1 1 1 1 1 0 0 0 0 0 3 3 3 3 4 4 4 3 3 3 3 3 10 11 11 11 11 11 10 10 10 11 4 
4 2 1 1 1 1 1 0 0 0 0 0 0 0 0 0 0 0 0 0 0 0 0 0 0 0 0 0 0 0 0 0 0 0 1 3 3 3 3 3 10 10 11 11 11 10 10 11 10 4 
4 3 3 3 3 3 1 1 1 1 0 0 0 0 0 0 0 0 0 0 0 0 0 0 0 0 0 0 0 0 0 0 0 0 0 1 3 3 3 3 11 10 11 10 10 0 10 11 11 4 
4 3 3 3 3 3 3 3 1 0 0 0 1 3 4 4 4 3 3 1 1 1 1 1 1 1 1 1 3 3 3 4 4 4 0 1 3 3 3 3 3 11 10 10 0 0 0 11 11 4 
4 3 3 3 3 3 3 1 1 0 0 3 3 3 4 4 4 3 3 3 3 3 1 1 1 3 1 3 3 3 3 4 4 4 0 0 3 3 3 3 3 3 3 3 3 0 0 3 3 4 
4 3 3 1 3 3 1 1 0 0 3 3 3 3 4 4 4 3 3 3 3 3 1 1 1 3 3 3 3 3 3 4 4 4 1 0 3 3 3 3 3 3 3 3 0 0 0 3 3 4 
4 1 3 1 3 1 1 1 0 1 3 3 3 1 4 4 4 3 3 3 3 1 1 1 1 1 3 3 3 3 3 4 4 4 1 0 0 3 3 3 3 3 3 1 0 0 1 1 3 4 
4 1 3 1 3 1 1 0 0 1 3 3 1 3 4 4 4 3 3 3 1 1 1 1 1 1 1 3 3 3 3 4 4 4 3 1 0 0 0 0 0 0 0 0 0 1 1 3 3 4 
4 1 3 3 3 1 1 0 0 1 3 3 3 3 4 4 4 3 3 3 1 1 1 0 1 1 1 3 3 3 3 4 4 4 3 1 1 0 0 0 0 0 0 0 1 1 3 3 3 4 
4 3 3 0 0 0 0 0 1 3 3 3 3 3 4 4 4 3 3 3 1 1 1 1 1 1 1 3 3 3 3 4 4 4 1 1 1 1 1 1 1 1 1 1 1 3 5 5 3 4 
4 3 0 0 0 0 0 0 0 1 3 1 3 1 4 4 4 3 3 3 3 1 1 1 1 1 3 3 3 3 3 4 4 4 3 3 1 1 1 1 1 3 3 3 5 5 5 5 3 4 
4 3 0 0 0 0 0 0 0 1 3 3 3 3 4 4 4 3 3 3 3 3 1 1 1 3 3 3 3 3 3 4 4 4 3 1 1 1 3 1 3 3 3 3 5 5 5 5 3 4 
4 1 0 0 0 0 0 0 0 3 3 3 3 3 4 4 4 3 3 3 3 3 1 1 1 3 3 3 1 3 1 4 4 4 1 1 1 3 3 3 3 3 3 5 5 5 5 5 3 4 
4 3 3 1 0 0 0 0 3 3 3 3 3 3 4 4 4 3 3 3 3 3 3 1 3 3 3 1 3 3 1 4 4 4 1 3 1 1 1 3 3 3 3 5 5 5 5 5 3 4 
4 1 3 1 1 0 0 1 3 1 5 5 5 3 4 4 4 3 1 3 3 3 3 1 3 3 3 3 3 3 3 4 4 4 1 3 3 3 1 1 3 3 3 3 5 5 5 5 3 4 
4 3 3 3 3 3 3 3 3 5 5 5 5 3 4 4 4 3 3 3 3 3 3 1 3 3 3 3 3 3 3 4 4 4 1 3 3 3 1 3 3 3 3 3 3 5 5 5 3 4 
4 3 1 3 3 3 3 1 3 5 5 5 3 3 4 4 4 3 3 3 3 3 3 3 3 3 3 3 3 3 3 4 4 4 3 1 3 3 1 3 3 3 3 3 3 5 5 5 3 4 
4 3 1 3 3 3 3 3 3 5 5 5 3 3 4 4 4 3 3 3 3 3 3 3 3 3 3 3 3 3 3 4 4 4 3 3 3 1 1 1 1 1 1 3 3 3 5 5 3 4 
4 3 3 3 3 3 1 3 5 5 5 5 3 3 4 4 4 3 3 3 3 3 3 3 3 3 3 3 3 3 3 4 4 4 3 3 3 1 3 3 3 1 1 1 1 1 1 1 1 4 
4 4 4 4 4 4 4 4 4 4 4 4 4 4 4 4 4 4 4 4 4 4 4 4 4 4 4 4 4 4 4 4 4 4 4 4 4 4 4 4 4 4 4 4 4 4 4 1 1 4 
4 4 4 4 4 4 4 4 4 4 4 4 4 4 4 4 4 4 4 4 4 4 4 4 4 4 4 4 4 4 4 4 4 4 4 4 4 4 4 4 4 4 4 4 4 4 4 4 1 4 
4 4 4 4 4 4 4 4 4 4 4 4 4 4 4 4 4 4 4 4 4 4 4 4 4 4 4 4 4 4 4 4 4 4 4 4 4 4 4 7 7 7 4 4 4 4 4 4 1 4 
4 6 6 7 7 7 7 6 6 6 6 6 6 6 6 6 6 6 6 6 6 6 6 6 6 6 6 6 6 6 6 6 6 6 6 6 6 6 6 6 6 7 7 7 7 7 7 7 0 4 
4 6 7 7 6 6 6 6 6 6 6 6 6 6 7 7 6 6 6 6 7 6 7 7 7 6 6 6 7 7 6 6 6 6 6 6 6 6 6 6 7 7 7 7 7 7 7 7 0 4 
4 6 6 6 6 6 6 6 7 7 7 6 6 6 7 6 6 6 6 6 7 7 6 6 6 6 6 7 7 7 6 6 7 6 6 6 6 6 6 6 7 7 7 7 7 7 6 7 0 4 
4 6 7 6 6 6 6 7 7 7 7 7 6 6 6 6 6 6 6 6 6 6 6 6 6 6 6 7 7 6 6 7 7 7 7 7 7 7 6 6 6 7 7 7 7 6 6 7 0 4 
4 7 7 6 6 6 7 7 7 7 7 7 7 6 6 6 6 6 7 7 6 6 7 7 7 7 6 6 6 7 7 7 7 7 7 7 7 7 7 7 6 6 6 7 7 6 6 7 0 4 
4 6 7 6 6 6 7 7 7 7 7 7 7 7 7 7 7 7 7 7 7 7 7 7 7 7 7 7 7 0 0 0 0 0 0 0 0 0 7 7 7 6 6 6 6 6 6 7 0 4 
4 6 6 6 6 6 7 7 7 7 7 7 7 7 7 7 7 7 7 7 7 7 7 0 0 0 0 0 0 0 7 7 7 7 7 7 0 0 0 7 7 7 7 6 6 6 7 0 0 4 
4 6 6 6 6 6 6 7 7 7 7 7 6 6 6 6 6 6 6 7 7 7 0 0 0 0 7 7 7 7 7 7 7 7 7 7 7 7 0 0 0 7 7 7 7 7 7 0 0 4 
4 6 7 6 6 6 6 6 7 7 7 6 6 6 6 6 6 6 7 7 7 7 7 7 7 7 7 7 6 6 6 6 6 6 6 7 7 7 7 7 0 0 0 0 0 0 0 0 0 4 
4 6 7 7 6 6 6 6 6 6 6 6 6 6 6 6 6 7 7 7 7 7 6 6 6 6 6 6 6 6 6 6 6 6 6 6 6 6 7 7 7 7 0 0 0 0 0 0 0 4 
4 6 7 7 7 7 6 6 6 6 6 6 6 7 6 6 6 7 7 7 7 6 6 6 6 6 6 6 6 7 7 7 6 6 6 6 6 6 6 6 6 7 7 7 0 0 0 0 0 4 
4 6 7 7 6 6 6 6 6 7 6 6 6 6 6 6 6 7 6 6 6 6 6 6 6 6 6 7 7 7 7 7 6 6 6 6 6 6 6 6 6 6 6 7 7 7 0 0 0 4 
4 4 4 4 4 4 4 4 4 4 4 4 4 4 4 4 4 4 4 4 4 4 4 4 4 4 4 4 4 4 4 4 4 4 4 4 4 4 4 4 4 4 4 4 4 4 4 4 4 4 
